Character	Main
Abomination	Abomination
Dormak	Abomination
Kinaelyan	Abomination
Koreksis	Abomination
Niluvien	Abomination
Venaelen	Abomination
Yinikren	Abomination
Adilene	Adilene
Rorak	Adilene
Eleander	Adilene
Taeja	Adilene
Zablis	Adilene
Dissonance	Adilene
Advocatus	Advocatus
Aramis	Advocatus
Arithorn	Advocatus
Arte	Advocatus
Bates	Advocatus
Dartagnan	Advocatus
Ladanger	Advocatus
Nicandreas	Advocatus
akbar	akbar
drel	akbar
Badman	akbar
dren	akbar
petish	akbar
Aldiss	Aldiss
Piama	Aldiss
Oiron	Aldiss
Lyndon	Aldiss
Gondry	Aldiss
Kdat	Aldiss
Zagyre	Aldiss
Amirite	Amirite
Giknagok	Amirite
Index	Amirite
Menrez	Amirite
Monster	Amirite
Naicigam	Amirite
Sing	Amirite
ammomage	Ammordius
Ammomats	Ammordius
Ammordius	Ammordius
healammo	Ammordius
ezram	Ammordius
Iaminae	Ammordius
whammo	Ammordius
badammo	Ammordius
Shadowammo	Ammordius
tandiyen	Ammordius
Malosammo	Ammordius
Badammo	Ammordius
Rezammo	Ammordius
Tappyammo	Ammordius
Whammo 	Ammordius
Animalammo	Ammordius
Animale	Animaul
Animaul	Animaul
Anviil	Animaul
Azlana	Azlana
Binning	Azlana
Baily	Baily
Daniro	Baily
Driftwood	Baily
Kaily	Baily
Kinador	Baily
Meepster	Baily
Barlu	Barlu
Billrussell	Barlu
Shaq	Barlu
Larrybird	Barlu
Rompa	Barndog
Barnabis	Barndog
Barncat	Barndog
Barndog	Barndog
Barnpig	Barndog
Barnpiggy	Barndog
Melta	Barndog
Scrappa	Barndog
Slacka	Barndog
Snorta	Barndog
Stompa	Barndog
Thumpa	Barndog
Tracka	Barndog
Barnbat	Barndog
Barndoor	Barndog
Disorda	Barndog
Beanwolf	Beanwolf
Beaniron	Beanwolf
Beirut	Beirut
Boat	Beirut
Patent	Beirut
Bhodi	Bhodi
Biko	Bhodi
Juliah	Bhodi
Winstonn	Bhodi
Stanlee	Bhodi
Navalny	Bhodi
Bhodistrader	Bhodi
Shizo	Bizo
Snarzo	Bizo
wizo	Bizo
Bizo	Bizo
Stunzo	Bizo
Blaline	Blaline
Periheed	Blaline
Baeloc	Blaline
Bopp	Bopp
Topp	Bopp
Tubb	Bopp
Ropp	Bopp
Nopp	Bopp
Brando	Brando
Buzzle	Brando
Glipton	Brando
RainDancer	Brando
Breathless	Breathless
Ceeline	Breathless
Porticus	Breathless
Burgee	Burgee
mase	Burgee
xteni	Burgee
Captainhash	Captainhash
Yourroyal	Captainhash
Isharted	Captainhash
Molag	Captainhash
Sheo	Captainhash
Cawther	Captainhash
Baxtabs	Captainhash
Aceta	Captainhash
Dimir	Captainhash
Liltator	Captainhash
Titsmcgee	Captainhash
Cassimir	Cassimir
Arttemis	Cassimir
Balasten	Cavalier
Best	Cavalier
Blackguard	Cavalier
Cavalier	Cavalier
Dominar	Cavalier
Druzzil	Cavalier
Emperor	Cavalier
Fennin	Cavalier
Godly	Cavalier
Hypnotist	Cavalier
Jiva	Cavalier
Mundo	Cavalier
Nadaren	Cavalier
Path	Cavalier
Reilavac	Cavalier
Slowest	Cavalier
Solusek	Cavalier
Ungodly	Cavalier
Veeshans	Cavalier
Veteran	Cavalier
Wanderer	Cavalier
Zephyl	Cavalier
Christis	Christis
Arethir	Christis
Shadeaux	Christis
Nakita	Christis
Sartan	Christis
Jaren	Christis
Zippoh	Christis
Treesbro	Christis
Shamwolf	Christis
Pantex	Christis
Aldon	Christis
Gimlee	Christis
Telchar	Christis
Sneakzee	Christis
Sylphira	Christis
Shamewolf	Christis
Telchar	Christis
Sylphira	Christis
Dilos	Christis
Clegane	Clegane
Durkin	Clegane
Maxwell	Clegane
Dutchi	Clegane
Murt	Clegane
Benjin	Clegane
Rafe	Clegane
Cogne	Cogne
Parsifal	Cogne
Crushzilla	Crushzilla
Dwight	Crushzilla
Gorgoo	Crushzilla
Bidens	Crushzilla
Kravyn	Crushzilla
Lexarin	Crushzilla
Trexin	Crushzilla
Grulp	Crushzilla
Culkasi	Culkasi
Cutten	Cutten
Cristyl	Cutten
Eyesen	Cutten
Ferstin	Cutten
Kaelinia	Cutten
Lindaine	Cutten
Mondino	Culkasi
Danzig	Danzig
Deerhunter	Danzig
Dirtydeeds	Danzig
Gwar	Danzig
Holydiver	Danzig
Misfit	Danzig
Willie	Danzig
Ziggystardust	Danzig
Darco	Darco
Muess	Darco
Darnite	Darco
Debrie	Debrie
Pistolwhip	Debrie
Lachan	Debrie
Aluminium	Debrie
Chud	Debrie
Frutebrute	Debrie
Zanzibart	Debrie
Zootsuits	Debrie
Chealfo	Deathfo
Deathfo	Deathfo
Dotsfo	Deathfo
Kitesfo	Deathfo
Mezfo	Deathfo
Demonicadhd	Demonicadhd
Dima	Dima
Duet	Dima
Hopkins	Diox
Shooty	Diox
Callebaut	Diox
Concierge	Diox
Hopkins	Diox
Diox	Diox
Jalen	Diox
Norseh	Diox
Valrhona	Diox
Guittard	Diox
Dopp	Dopp
Beep	Dopp
Xopp	Dopp
Yopp	Dopp
Zopp	Dopp
Lopp	Dopp
Dosch	Dosch
Jandael	Dosch
Jarbarmarfarzar	Dosch
Brendan	Dula Allazaward
Chay	Dula Allazaward
Dula	Dula Allazaward
Avada	Duncann
Draekin	Duncann
Draeko	Duncann
Dravada	Duncann
Duncann	Duncann
Dunwon	Duncann
Edwin	Duncann
Jaskier	Duncann
Revan	Duncann
Setephen	Duncann
Solas	Duncann
Tuolen	Duncann
Amilya	Eilfie
Eilfie	Eilfie
Elsie	Eilfie
Eliya	Eliya
Ellyas	Ellyas
Miriam	Ellyas
Prepotente	Ellyas
Elcid	Elcid
Speedie	Elcid
Elrontaur	Elrontaur
Gaia	Elrontaur
Medea	Elrontaur
Taolosia	Elrontaur
Eartha	Elrontaur
Scorch	Elrontaur
Destroyah	Elrontaur
Atillienne	Emryes
Elio	Emryes
Emryes	Emryes
Gjintari	Emryes
River	Emryes
alaenie	Enot
Enot	Enot
outz	Enot
tradenot	Enot
Fanglore	Fanglore
Jugo	Fanglore
Jiru	Fanglore
Jago	Fanglore
Hawk	Fanglore
Jago	Fanglore
Fayze	Fayze
Jamz	Fayze
Raud	Fayze
Fireblade	Fireblade
Ephedra	Fireblade
Kintsugi	Fireblade
Shredler	FIreblade
Fedora	FIreblade
Swiftblade	FIreblade
Toguruk	Fireblade
Sarenia	Fireblade
Firehand	Fireblade
Flawed	Flawed
Forgiving	Flawed
Slog	Flawed
Freedom	Freedom
Grakkus	Freedom
Fridgelargemeat	Fridgelargemeat
Pastorious	Fridgelargemeat
Staab	Fridgelargemeat
Donut	Fridgelargemeat
Gore	Fridgelargemeat
Slab	Fridgelargemeat
Cothero	Frinop
Diresta	Frinop
Frinop	Frinop
Intel	Frinop
Mythoss	Frinop
Debo	Frinop
Rounder	Frinop
Scarf	Frinop
Tunn	Frinop
Varnish	Frinop
Fungusfeet	Fungusfeet
Goodguy	Fungusfeet
Spitball	Fungusfeet
Sprinkle	Fungusfeet
korpo	Fungusfeet
Twigen	Fungusfeet
Fuzy	Fuzy
Bighead	Fuzy
Ghosts	Fuzy
Yumy	Fuzy
Sultan	Galdawm
Galdawm	Galdawm
Hawtsauce	Galdawm
Whadafuc	Galdawm
Feekkin	Gamuk
Gamuk	Gamuk
Sash	Gamuk
Balara	Gheff
Evereyes	Gheff
Gheff	Gheff
Gheffwar	Gheff
Gkssizz	Gheff
Gmeff	Gheff
Brisket	Gorren
Coolaid	Gorren
Lips	Gorren
Zalendar	Gorren
Muertos	Gorren
Gorren	Gorren
Guitar	Gorren
Klowns	Gorren
Mulil	Gorren
Malliki	Gorren
Rubicant	Gorren
Kythia	Gorren
Adaria	Grimdahl
Balthasar	Grimdahl
Durango	Grimdahl
Grimdahl	Grimdahl
Kilea	Grimdahl
Manekiki	Grimdahl
Maunianai	Grimdahl
Neith	Grimdahl
Sinbad	Grimdahl
Strange	Grimdahl
Venadan	Grimdahl
Bolfo	Grimlocke
Contractor	Grimlocke
Grimlocke	Grimlocke
Oconomowoc	Grimlocke
Sassle	Grimlocke
Shrubbery	Grimlocke
Sisle	Grimlocke
Vothril	Grimlocke
Sharebear 	Grimlocke
Breaks	Gulo
Grubble	Gulo
Gulo	Gulo
Wiar	Gulo
Hamorf	Hamorf
Palon	Hamorf
Thundara	Hamorf
Gumma	Hamorf
Necrosis	Hamorf
Zosweet	Hamorf
Rincewind	Hamorf
Strummin	Hamorf
Handolur	Handolur
Welorf	Handolur
Oldirty	Handolur
Fattwin	Handolur
headcrushar	Headcrushar
Nevyr	Headcrushar
Hinora	Hinora
Hodoor	Hodoor
Orville	Hodoor
Drougar	Hodoor
Hoodor	Hodoor
Nuktur	Hodoor
Hollowlung	Hollowlung
Hollows	Hollowlung
Toporz	Hollowlung
Htaed	Htaed
Olem	Htaed
Retsam	Htaed
Revo	Htaed
Cinamon	Iddaa
Iddaa	Iddaa
Lanny	Iddaa
Summor	Iddaa
Drudge	Inacht
Inacht	Inacht
Larch	Inacht
Perch	Inacht
Jackyydaytona	Jackyydaytona
Tanladar	Jackyydaytona
Tragicjohnson	Jackyydaytona
Ellia	Jade
Grunt	Jade
Jade	Jade
Leha	Jade
Mumble	Jade
Quinn	Jade
Rockbell	Jade
Seles	Jade
Syana	Jade
Strife	Jade
Dullwin	Jarisy
Jaricle	Jarisy
Jaridru	Jarisy
Jarienc	Jarisy
Jarisk	Jarisy
Jarisy	Jarisy
Jasyri	Jarisy
Lalyen	Jarisy
Jarisytrader	Jarisy
Radan	Jarisy
Soril	Jarisy
Balbao	Jojobo
Jisu	Jisu
Heesun	Jisu
Karyna	Jisu
Esse	Jojobo
Jojobar	Jojobo
Jojobo	Jojobo
Jojon	Jojobo
Jyslia	Jyslia
Garas	Jyslia
ICBM	Jyslia
Cecia	Jyslia
Dystopia	Jyslia
Morgul	Jyslia
Carny	Jyslia
Nymm	Jyslia
Skalde	Jyslia
Audrianna	Kaerilai
Faster	Kaerilai
Kaedar	Kaerilai
Kaefassa	Kaerilai
Kaeralott	Kaerilai
Luminaire	Kaerilai
Chokolat	Kaerilai
Kaerfree	Kaerilai
Kaerilai	Kaerilai
Kaerlass	Kaerilai
Kaerliss	Kaerilai
Kaerlii	Kaerilai
Kaielen	Kaielen
Kaieten	Kaielen
Kaiezen	Kaielen
Kandias	Kandias
Classical	Kandias
Minuuar	Kandias
Pacino	Kandias
Slowdown	Kandias
Lepro	Kandias
Jynx	Kandias
Karol	Karol
Xeraax	Karol
Aanie	Karol
Mara	Karol
Kalar	Karol
Genefur	Khord
Khaine	Khord
Khalin	Khord
Khalos	Khord
Khellon	Khord
Khord	Khord
Kohler	Kohler
Fattyfatty	Kohler
Worcestershire	Kohler
Ktwo	Kohler
Kthree	Kohler
Ceirala	Kohler
Kovah	Kovah
Kovac	Kovah
Ernham	Kovah
Randan	Kovah
Tebirian	Kovah
Arthain	Kovah
Pricia	Kovah
Slade	Kovah
Kuroinu	Kuroinu
Ladakh	Ladakh
Lalisa	Lalisa
Exodas	Lalisa
Percept	Lalisa
Coalesce	Lalisa
Melanie	Lalisa
Meledus	Lalisa
Anane	Lamia
Holle	Lamia
Kycia	Lamia
Laki	Lamia
Lamia	Lamia
Lyae	Lamia
Mokli	Lamia
Yuuki	Lamia
Crusade	Maclin
Maclin	Maclin
Revive	Maclin
Windas	Maclin
Akatosh	Mandown
Akiva	Mandown
Atreus	Mandown
Entreri	Mandown
Frostir	Mandown
Ifriit	Mandown
Jenova	Mandown
Krado	Mandown
Lowkey	Mandown
Mandown	Mandown
Mehrune	Mandown
Neptune	Mandown
Oceania	Mandown
Shades	Mandown
Yokuda	Mandown
Zaetos	Mandown
Manstache	Manstache
Tarrasque	Manstache
Tundra	Manstache
Prester	Manstache
Varlot	Manstache
Horse	Manstache
Chillary	Manstache
brahn	Mather
Gruhm	Mather
Mather	Mather
Meriadoc	Meriadoc
Baginses	Meriadoc
Bandobras	Meriadoc
Iarwain	Meriadoc
Isengar	Meriadoc
Olorien	Meriadoc
Peregrin	Meriadoc
Samuel	Meriadoc
Romestamo	Meriadoc
Tuine	Meriadoc
Goldberry	Meriadoc
Eventually	Mewmew
Mewmew	Mewmew
Look	Meww
Ervyn	Meww
Mind	Meww
Coth	Meww
Lift	Meww
Meww	Meww
Mimikyu	Mimikyu
Minnec	Minpal
Minpal	Minpal
Minsham	Minpal
Mojobard	Mojochanter
Mojobeast	Mojochanter
Mojochanter	Mojochanter
Mojodruid	Mojochanter
Mojomage	Mojochanter
Thekthee	Mojochanter
Monara	Monara
Aphrael	Monara
Baru	Monara
Isashi	Monara
Ignite	Monara
Ferha	Monara
Ishira	Monara
Ifuri	Monara
Mirtai	Monara
Sonnet	Monara
Ketchup	Moonshine
Moonshine	Moonshine
Whostabbedya	Moonshine
Akuma	Mrfreeze
Akuma	Mrfreeze
Mrfreeze	Mrfreeze
Mrfreeze	Mrfreeze
Speedracer	Mrfreeze
Speedracer	Mrfreeze
Bozzo	Mudbut
Friskay	Mudbut
Mudbut	Mudbut
Munyla	Munyla
Muver	Muver
Hunnah 	Muver
Necromanz	Necromanz
Druidymanz	Necromanz
Beastymanz	Necromanz
Necrophobia	Necrophobia
Anthropogenic	Necrophobia
Nostrum	Necrophobia
Repugnant	Necrophobia
Littlernemce	Nemce
Nemce	Nemce
Kormak	Neokkin
Neokkin	Neokkin
Musselz	Neokkin
clamz	Neokkin
Gabbo	Neokkin
Drekken	Neokkin
Nizshad	Nizshad
BeefJerky	Nizshad
Nizmag	Nizshad
Notoriousone	Notoriousone
Jyxxt	Notoriousone
Deunknown	Notoriousone
Noze	Noze
Lefty	Noze
Bubbs	Noze
Aramere	Nyashem
Ayashem	Nyashem
Berekoth	Nyashem
Cambion	Nyashem
Casimere	Nyashem
Drusilla	Nyashem
Khastagere	Nyashem
Mordred	Nyashem
Nyashem	Nyashem
Odette	Nyashem
Tiamut	Nyashem
Omegalord	Omegalord
Omegastorm	Omegalord
Stormwind	Onward
Wildwind	Onward
Onward	Onward
Paen	Paen
Palarran	Palarran
Cantabile	Palarran
Odla	Palarran
Ponderll	Palarran
Zark	Palarran
Beastski	Palski
Chantski	Palski
Druski	Palski
Jamski	Palski
Nukeski	Palski
Palski	Palski
Shotski	Palski
Firstaid	Paolin
Kindawen	Paolin
Mcrib	Paolin
Mezsz	Paolin
Nuggets	Paolin
Paolin	Paolin
Playthat	Paolin
Voila	Paolin
Abridax	Papertank
Butdidyadie	Papertank
Faelyndel	Papertank
Papertank	Papertank
Rizza	Papertank
Pearl	Pearl
Zores	Pearl
Sorez	Pearl
Namilea	Pearl
Piama	Piama
Aldiss	Piama
Oiron	Piama
From	Pickletickle
Kendrella	Pickletickle
Krazaak	Pickletickle
Mezzamphetameme	Pickletickle
Millar	Pickletickle
Pickletickle	Pickletickle
Xltz	Pickletickle
Fizbog	Pretzella
Gyda	Pretzella
Pigpen	Pigpen
Oink	Pigpen
Phacochoerus	Pigpen
Squeal	Pigpen
Gracemina	Pigpen
Dongpo	Pigpen
Pretzella	Pretzella
Pretzmule	Pretzella
Hundy	Pryze
Lidden	Pryze
Pryze	Pryze
Pugnacious	Pugnacious
Audacious	Pugnacious
Bodacious	Pugnacious
Salacious	Pugnacious
Vivacious	Pugnacious
Voracious	Pugnacious
Fallacious	Pugnacious
Tenacious	Pugnacious
Pursuit	Pursuit
Ministry	Pursuit
Brio	Pursuit
Melodie	Pursuit
Malady	Pursuit
Ellasaria	Pursuit
Dust	Pursuit
Scath	Pursuit
Ashes	Pursuit
Pyrexia	Pursuit
Chantry	Pursuit
Cher	Qazadan
Chugalug	Qazadan
Enigma	Qazadan
Gluck	Qazadan
Havuk	Qazadan
Huggs	Qazadan
Hussar	Qazadan
Imhotep	Qazadan
Magica	Qazadan
Malus	Qazadan
Nirre	Qazadan
Qazadan	Qazadan
Serenade	Qazadan
Soprano	Qazadan
Theoderic	Qazadan
Therapy	Qazadan
Drakor	Quillen
Evoc	Quillen
Fronds	Quillen
Hahns	Quillen
Katatonic	Quillen
Montague	Quillen
Quillen	Quillen
Tadmor	Quillen
Vigo	Quillen
Chariot	Radda
Mercedes	Radda
Radda	Radda
Type	Radda
Rangerwoodelf	Rangerwoodelf
Askepios	Rangerwoodelf
Drusella	Rangerwoodelf
Selva	Rangerwoodelf
Jove	Rangerwoodelf
Cicatriz	Rangerwoodelf
Joon	Rangerwoodelf
Baits 	Rangerwoodelf
Amile	Rangerwoodelf
Ifrit	Rangerwoodelf
Pallywoodelf	Rangerwoodelf
Jasie	Rangerwoodelf
Octahedron	Rangerwoodelf
Sycamore	Rangerwoodelf
Ecstasy	Rembylynn
Euphoria	Rembylynn
Pattchez	Rembylynn
Pulz	Rembylynn
Rembyen	Rembylynn
Rembylynn	Rembylynn
Remby	Rembylynn
Rgrok	Rgrok
Frok	Rgrok
Jowes	Rgrok
Rezrok	Rgrok
Portrok	Rgrok
Atar	Rimidal
Bees	Rimidal
Bicboi	Rimidal
Borat	Rimidal
Buylow	Rimidal
Chareth	Rimidal
Dees	Rimidal
Diversity	Rimidal
Fake	Rimidal
Fashion	Rimidal
Feels	Rimidal
Gluten	Rimidal
Howcan	Rimidal
Marle	Rimidal
Okay	Rimidal
Pobody	Rimidal
Prayers	Rimidal
Putin	Rimidal
Real	Rimidal
Rezziboi	Rimidal
Rimidal	Rimidal
Sexy	Rimidal
Sitka	Rimidal
Slatka	Rimidal
Swag	Rimidal
Szechuan	Rimidal
Tessitura	Rimidal
Thoughts	Rimidal
Tinns	Rimidal
Updog	Rimidal
Vegan	Rimidal
Dears	Roach
Fuggly	Roach
Meatball	Roach
Roach	Roach
Wedgies	Roach
Kald	Ruken
Kore	Ruken
Ruken	Ruken
Crackling	Ryukyu
Hodag	Ryukyu
Oaken	Ryukyu
Ryukyu	Ryukyu
Toxon	Ryukyu
Natashya	Safetouch
fleamarkit	Safetouch
Trumpette	Safetouch
Bowjobb	Safetouch
Kernwaffe	Safetouch
Plowya	Safetouch
Safetouch	Safetouch
Salan	Salan
catmint	Salan
Jane	Salan
Serra	Salan
Elonnii	Savok
Kavos	Savok
Kovas	Savok
Osvak	Savok
Savok	Savok
Skavo	Savok
Skova	Savok
Sovak	Savok
Vakos	Savok
Vasok	Savok
Bardo	Serro
Bott	Serro
Hunted	Serro
Mcbeasty	Serro
Mager	Serro
Olive	Serro
Popeye	Serro
Puller	Serro
Questia	Serro
Samwow	Serro
Serro	Serro
Suppin	Serro
Wizzie	Serro
Shaakti	Shaakti
Shaaktree	Shaakti
Alys	Shoosh
Port	Shoosh
Shoosh	Shoosh
Starboard	Shoosh
Julien	Shoosh
Sioux	Shoosh
Shanac	Shoosh
Yiss	Shoosh
Zaga	Shoosh
Zigi	Shoosh
Shortok	Shortok
Silent	Silent
Prynce	Silent
Leaf	Silent
Bloodninja	Silent
Catti	Silent
Shameow	Silent
Sturm	Silent
Buffin	Silent
Pallas	Silent
Apothe	Silent
Sizlak	Sizlak
Charlez	Skaruga
Cheezloaf	Skaruga
Daruga	Skaruga
Ehrasmus	Skaruga
Fibonachi	Skaruga
Garuga	Skaruga
Lacuna	Skaruga
Laruga	Skaruga
Maruga	Skaruga
Mezruga	Skaruga
Paruga	Skaruga
Tohjam	Skaruga
Tulako	Skaruga
Ubitrippen	Skaruga
Yeezee	Skaruga
Skaruga	Skaruga
Baby	Slay
Baine	Slay
Bobn	Slay
Bobobn	Slay
Leegion	Slay
Legend	Slay
Mezze	Slay
Rezze	Slay
Ruckus	Slay
Ryder	Slay
Slay	Slay
Lilspook	Spookey
Ninbik	Spookey
Spookey	Spookey
Tonedeaf	Spookey
Velocity	Spookey
Chewii	Sport
Kowe	Sport
Novo	Sport
Sport	Sport
Vilo	Sport
Spreckles	Spreckles
Drazid	Spreckles
Crikey	Spreckles
Letsgocamping	Spreckles
Phoom	Spreckles
Plutoid	Spreckles
Hoover	Steenke
Sownow	Steenke
Steenke	Steenke
Yiza	Steenke
Stickie	Stickie
Funkee	Stickie
Mankee	Stickie
Stankie	Stickie
Stinkee	Stickie
Stunkie	Stickie
Whiffee	Stickie
Surron	Surron
geom	Surron
fridge	Surron
Sverder	Sverder
Fillo	Sverder
Togor	Sverder
Delvean	Sverder
Enticer	Sverder
Lorke	Sverder
Taker	Taker
Tesadar	Tesadar
Megatron	Tesadar
Galaleio	Tesadar
Thornwood	Thornwood
Briarfoot	Thornwood
Sanuuven	Thornwood
Sevaren	Thornwood
Threllin	Threllin
Merfan	Threllin
Dakamere	Threllin
Afterthought	Tastycakes
Moonpie	Tastycakes
Tastycakes	Tastycakes
Dire	Thian
Whoops	Thian
koggrog	Thian
ssappy	Thian
Thian	Thian
Timmysk	Timmysk
Timmysham	Timmysham
Tolsarian	Tolsarian
Caluguin	Tolsarian
Creator	Tolsarian
Esfanto	Tolsarian
Estragon	Tolsarian
Inferno	Tolsarian
Inusar	Tolsarian
Kynsard	Tolsarian
Stefano	Tolsarian
Trevelyen	Trevelyen
Tudogs	Tudogs
Follow	Tudogs
Follin	Tudogs
Srik	Tudogs
Nautius	Tudogs
Tuen	Tuen
Ruen	Tuen
Luen	Tuen
Tuluvien	Tuluvien
Aether	Tuluvien
Alasdair	Tuluvien
Salvo	Tuluvien
Shakey	Tuluvien
Aila	Tuluvien
Tyrreni	Tyrreni
Uberest	Uberest
Shibi	Uberest
Enchanta	Uberest
Wouldelf	Uberest
Ranged	Uberest
	
Vanuk	Vanuk
Alyxandria	Vashen
Louispaws	Vashen
Vashen	Vashen
Andre	Verdent
Asimov	Verdent
Butter	Verdent
Faunus	Verdent
Inigo	Verdent
Lanklus	Verdent
Pkewanay	Verdent
Tacklebox	Verdent
Verdent	Verdent
balefire	Verduaga
kanyen	Verduaga
Verduaga	Verduaga
Aluolen	Walex
Baeras	Walex
Banrek	Walex
Dedden	Walex
Kakamar	Walex
Nilren	Walex
Oogok	Walex
Rukik	Walex
Senelen	Walex
Vaeinae	Walex
Walex	Walex
Xelaw	Walex
Astrid	Wanor
Blasterr	Wanor
Kini	Wanor
Lorrd	Wanor
Partee	Wanor
Wanor	Wanor
Xisbik	Wanor
Happywispers	Warboss
Sirc	Warboss
Warboss	Warboss
Wish	Warboss
Wesley	Wesley
Hailey	Wesley
Benjamin	Wesley
Caveat	Wesley
Prevaricate	Wesley
Filibuster	Wesley
Ultimatum	Wesley
Wildcaller	Wildcaller
Sexytank	Wildcaller
Buffbotgirl	Wildcaller
Callsindrag	Wildindrag
Contagion	Wildindrag
Dazeindrag	Wildindrag
Deathindrag	Wildindrag
Faithindrag	Wildindrag
Fleschette	Wildindrag
Friggie	Wildindrag
Healsindrag	Wildindrag
Heatwave	Wildindrag
Hugsindrag	Wildindrag
Kissin	Wildindrag
Leper	Wildindrag
Playsindrag	Wildindrag
Pokken	Wildindrag
Rezbian	Wildindrag
Vitae	Wildindrag
Wildindrag	Wildindrag
Xcivi	Xcivi
Axivi	Xcivi
Hewgo	Xaiterlyn
Rockum	Xaiterlyn
Rlee	Xaiterlyn
Stylyx	Xaiterlyn
Hammerlock	Xaiterlyn
Traplie	Xaiterlyn
Xaiterlyn	Xaiterlyn
Akatchi	Xaiterlyn
Xyphen	Xyphen
Samaorn	Xyphen
Mildain	Xyphen
Defect	Xyphen
Hypnotize	Yvonne
Maura	Yvonne
Phae	Yvonne
Ysolde	Yvonne
Yvette	Yvonne
Yvonne	Yvonne
Yuukii	Yuukii
Tenor	Yuukii
Aumaman	Yuukii
Kyou	Yuukii
Sairen	Yuukii
Aedros	Yuukii
Robet	Yuukii
Tylendel	Yuukii
Vanyel	Yuukii
Stefenn	Yuukii
Tenor	Yuukii
Zaltak	Zaltak
Mabampus	Zaltak
Zalmonk	Zaltak
Zalsham	Zaltak
Corgano	Zekkez
Rouje	Zekkez
Zekkez	Zekkez
Zelus	Zelus
Impulse	Zelus
Oblivia	Zender
Phorno	Zender
Zender	Zender
Noir	Zentile
Zentile	Zentile
Citron	Zentile
Zetter	Zetter
Miko	Zetter
Henrik	Zetter
Girtata	Zetter
Killianka	Zetter
Gustopher	Zetter
	
	
	
	
	
	
	
	
	
	
	
	
	
	
	
	
	
	
	
	
	
	
	
	
	
	
	
	
	
	
	
	
	
	
	
	
	
	
	
	
	
	
	
	
	
	
	
	
	
	
	
	
	
	
	
	
	
	
	